1111111111111111
100000000P000001
100000000CCCCC01
10E0000000MMMM01
1111111111111111