11111111111111111111111111111111
1000000011111111100000000P000001
111111E00000C000C111111111111111
100000000000C000000000000C000001
100000000000C000000000000C000001
100000000000C000000000000C000001
100000000000C000000000000C000001
100000000000C000000000000C000001
100000000000C000000000000E000001
11111111111111111111111111111111