111111111111111111111111111111111111111111111111111111111111111111111
111011111111111111111111111111110111110100000000000000000000000000001
11101111111111111111111111111111011111010000000000000000C000000000001
11101111111111111111111111111111100000000000000000000000C000000000001
1110C0000000000000M000000000000000000010000000000000000C0000000001011
111010000000000000M00000000001110100000000011000000000C00001110111011
111111110111111111111111110101110000011111111111111111111111111111111
10000000000000000M000000010101110000011111111111111111111111111111111
1110C0000000000000000000000000000000000001011111111110101011010000011
111000010110111111100010000101110000000011111111111111111100010111011
10111000000000000000000000000000000000001111111111111C111000101110111
100000000000000000000000000001110111111111111111111111C11100010111011
1011100000000000P0000000000001110111111111111111111111C11000101110111
111010111111011111111111111111110111111111111111111111111000101110111
101110111111111111111111111111110111111111111111111111111000101110111
111010000000000000000000000000000111111111111111111111111000101110111
111011111111111111111111111111110111111111111111111111111000101110111
1110C000000000000M0000000000000001111111111111111111111110E0101110111
111111111111111111111111111111111111111111111111111111111000101110111
111111111111111111111111111111111111111111111111111111111111111111111