1111111111111111111111111111111111
1000110001000000M00000001100011101
1110110101111111111010101101011101
1110000101101111111000100001011101
1111111101100000000000000111011101
1111111101111111111111111101011101
1C00000000000000000000000101011101
1111111111111111111111110001011101
1000000000000000000000000000011101
1011101111111111111111011111111101
1011100000C00000000000000000000001
1011100000000000000000000000011101
1000101111111111110011111111111111
1110100000000000P00000E00000000101
1110100000000000000000000000011101
1000000000000000000000000000000101
10000000000000000M0000000000000011
11000000000000000M0000000000000001
11100000000000000M0000000000000001
1111111111111111111111111111111111