111111111111111111111111111111111111111111111111111111111111
10000P000000000000000000000000000000000000000000000000000001
100000000000000000000000000000000000000000000000000000000001
100000000000000000000000000000000000000000000000000000000001
1000000000000000000000000000000000000000C0000000000000000001
100000000000000000000000000000000000000000000000000000000001
1000000000000000000000000000000C0000000000000000000000000001
1000000000000000000000000000000C0000000000000000000000000001
1000000000000000000000000000000C0000000000000000000000000001
1000000000000000000000000000000C0000000000000000000000000001
1000000000000000000000000000000C0000000000000000000000000001
1000000000000000000000000000000C0000000000000000000000000001
1000000000000000000000000000000C0000000000000000000000000001
1000000000000000000000000000000C0000000000000000000000000001
100000000000000000000000000000000000000000000000000000000001
100000000000000000000000000000000000000000000000000000000001
100000000000000000000M00000000000000000000000000000000000001
100000000000000000000M000000000000000000000000000000E0000001
100000000000000000000M00000000000000000000000000000000000001
100000000000000000000M00000000000000000000000000000000000001
111111111111111111111111111111111111111111111111111111111111