1111111111111
100M0EP100001
1CEC000100M01
1111111111111