1111111111111111111111111111111111
1000110001000000000100011000110E01
1110110101111111111010101101000001
1110000101101111111000100001011101
1111111101100000000000000111011101
1111111101111111111111111101011101
1000000000000000000000000101011101
1111111111111111111111110001011101
1000000000000000000000000000011101
1011101111111111111111111111111101
1011100000000000000000000000000001
1011100000000000P00000000000011101
1000101111111111110011111111111111
1110100000000000000000000000000101
1110100000000000000000000000011101
1110101111110111111111111111111101
1110100000000000000000000000000001
1110111111111111111111111111111101
1110C00000000000000000000000000001
1111111111111111111111111111111111